NO ./texture/wall_n.xpm
SO ./texture/asdasd.xpm
WE ./texture/c.xpm
EA ./texture/a.xpm

F 0,120,50
C 0,120,50

1111111111111
101111011111111
10000*0001 1
110111111111111
11S1111111
100001111111111
10000011111
10000011111
111111111111