NO ./texture/asdasd.xpm
SO ./texture/asdasd.xpm
WE ./texture/c.xpm
EA ./texture/a.xpm

F 0,120,50
C 0,10,120

11111111111111111111111111
1000000000110000000000001
1000000000110000000000001
1000000000110000000000001
1000000000110000000000001
1000000000110000000000001
1000000000110000000000001
1000000000110000000000001
1000000000110000000000001
1000000W00110000000000001
100100000000000000000000011111111
111111111011000001110000000000001
100000000011000001110111111111111
11111111111111011111100010001111111111111
          11110111   111111011101010010001
1111111111001011101111010001111111111111111
10000000000000001100000010001
10000000000000001101010010001
1100000111010011111010100111
11111111111111111111101111
111111111111111111111111111