NO ./texture/asdasd
SO ./texture/asdasd
WE ./texture/asdasd
EA ./texture/asdasd

F 220,100,0
C 225,30,255

11111111111111111111111111
1000000000110000000000001
1011000001110000000000001
1001000000000000000000001
111111111011000001110000000000001
100000000011000001110111111111111
11110111111111011100000010001
          11110111   111111011101010010001
1100000010010111000000100011
10000000000000001100000010001
10000000000000001101010010001
1100000111010011111011100111
111111111111111111111N11111
111101111110101101111010001